S

#####################





##############
#            #
#  B      B  #
####      ####
#   B B      #
# S ###      ###
#    0         #
####### ###### #
               #
            #  #
    ####    #  #
            #  #
            #  #
            #  #
            #  #
            #  #
            #  #
            ####

####### ###########################################
####### ###########################################
####### ###########################################
######                                    #########
######                                    #########
######                                    #########
######  #################                 #########
######                                    #########
######                                    #########
######                                    #########
######                                    #########
######                                    #########
######                                    #########
######                                    #########
######                                    #########
###### ######################             #########
######                                    #########
######                                    #########
######                                    #########
######                                    #########
######                                    #########
######                                    #########
######                                    #########
######                                    #########
######                                    #########
######                                    #########
######                                    #########
######                                    #########
######                                    #########
######                                    #########
######                                    #########
######                                    #########
######                                    #########
######                                    #########
######                                    #########
######                                    #########
######                                    #########
######                                    #########
######                                    #########
###################################################
###################################################
###################################################
###################################################
###################################################
###################################################
###################################################
###################################################
###################################################
###################################################
###################################################
###################################################
###################################################
###################################################
